64
64
24 24 24 24 24 24 24 48 49 24 24 24 24 24 24 24 0 0 0 0 0 0 0 0 0 0 0 0 0 0 0 0 0 0 0 0 0 0 0 0 0 0 0 0 0 0 0 0 0 0 0 0 0 0 0 0 0 0 0 0 0 0 0 0
24 2 3 3 3 3 3 3 3 3 3 3 3 3 2 24 0 0 0 0 0 0 0 0 0 0 0 0 0 0 0 0 0 0 0 0 0 0 0 0 0 0 0 0 0 0 0 0 0 0 0 0 0 0 0 0 0 0 0 0 0 0 0 0
24 3 2 3 3 3 3 3 3 3 3 3 3 2 3 24 0 0 0 0 0 0 0 0 0 0 0 0 0 0 0 0 0 0 0 0 0 0 0 0 0 0 0 0 0 0 0 0 0 0 0 0 0 0 0 0 0 0 0 0 0 0 0 0
24 3 3 2 2 2 3 3 3 3 2 2 2 3 3 24 0 0 0 0 0 0 0 0 0 0 0 0 0 0 0 0 0 0 0 0 0 0 0 0 0 0 0 0 0 0 0 0 0 0 0 0 0 0 0 0 0 0 0 0 0 0 0 0
24 3 3 2 4 2 2 2 2 2 2 4 2 3 3 24 0 0 0 0 0 0 0 0 0 0 0 0 0 0 0 0 0 0 0 0 0 0 0 0 0 0 0 0 0 0 0 0 0 0 0 0 0 0 0 0 0 0 0 0 0 0 0 0
24 3 3 2 2 2 3 3 3 3 2 2 2 3 3 24 0 0 0 0 0 0 0 0 0 0 0 0 0 0 0 0 0 0 0 0 0 0 0 0 0 0 0 0 0 0 0 0 0 0 0 0 0 0 0 0 0 0 0 0 0 0 0 0
24 3 3 3 2 3 24 24 24 24 3 2 3 3 3 24 0 0 0 0 0 0 0 0 0 0 0 0 0 0 0 0 0 0 0 0 0 0 0 0 0 0 0 0 0 0 0 0 0 0 0 0 0 0 0 0 0 0 0 0 0 0 0 0
24 3 3 3 2 3 24 2 2 24 3 2 3 3 3 24 0 0 0 0 0 0 0 0 0 0 0 0 0 0 0 0 0 0 0 0 0 0 0 0 0 0 0 0 0 0 0 0 0 0 0 0 0 0 0 0 0 0 0 0 0 0 0 0
24 3 3 3 2 3 24 2 2 24 3 2 3 3 3 24 0 0 0 0 0 0 0 0 0 0 0 0 0 0 0 0 0 0 0 0 0 0 0 0 0 0 0 0 0 0 0 0 0 0 0 0 0 0 0 0 0 0 0 0 0 0 0 0
24 3 3 3 2 3 24 48 49 24 3 2 3 3 3 24 0 0 0 0 0 0 0 0 0 0 0 0 0 0 0 0 0 0 0 0 0 0 0 0 0 0 0 0 0 0 0 0 0 0 0 0 0 0 0 0 0 0 0 0 0 0 0 0
24 3 3 2 2 2 3 3 3 3 2 2 2 3 3 24 0 0 0 0 0 0 0 0 0 0 0 0 0 0 0 0 0 0 0 0 0 0 0 0 0 0 0 0 0 0 0 0 0 0 0 0 0 0 0 0 0 0 0 0 0 0 0 0
24 3 3 2 4 2 2 2 2 2 2 4 2 3 3 24 0 0 0 0 0 0 0 0 0 0 0 0 0 0 0 0 0 0 0 0 0 0 0 0 0 0 0 0 0 0 0 0 0 0 0 0 0 0 0 0 0 0 0 0 0 0 0 0
24 3 3 2 2 2 3 3 3 3 2 2 2 3 3 24 0 0 0 0 0 0 0 0 0 0 0 0 0 0 0 0 0 0 0 0 0 0 0 0 0 0 0 0 0 0 0 0 0 0 0 0 0 0 0 0 0 0 0 0 0 0 0 0
24 3 2 3 3 3 3 3 3 3 3 3 3 2 3 24 0 0 0 0 0 0 0 0 0 0 0 0 0 0 0 0 0 0 0 0 0 0 0 0 0 0 0 0 0 0 0 0 0 0 0 0 0 0 0 0 0 0 0 0 0 0 0 0
24 2 3 3 3 3 3 3 3 3 3 3 3 3 2 24 0 0 0 0 0 0 0 0 0 0 0 0 0 0 0 0 0 0 0 0 0 0 0 0 0 0 0 0 0 0 0 0 0 0 0 0 0 0 0 0 0 0 0 0 0 0 0 0
24 24 24 24 24 50 51 24 24 24 24 24 24 24 24 24 0 0 0 0 0 0 0 0 0 0 0 0 0 0 0 0 0 0 0 0 0 0 0 0 0 0 0 0 0 0 0 0 0 0 0 0 0 0 0 0 0 0 0 0 0 0 0 0
24 28 28 28 24 3 3 24 28 28 28 28 28 28 28 28 24 24 24 24 24 24 24 24 24 24 24 24 24 24 24 24 0 0 0 0 0 0 0 0 0 0 0 0 0 0 0 0 0 0 0 0 0 0 0 0 0 0 0 0 0 0 0 0
24 28 28 28 24 2 2 24 28 28 28 28 28 28 28 28 24 3 3 3 3 3 3 3 3 3 3 3 3 3 3 24 0 0 0 0 0 0 0 0 0 0 0 0 0 0 0 0 0 0 0 0 0 0 0 0 0 0 0 0 0 0 0 0
24 28 28 28 24 3 3 24 28 28 28 28 28 28 28 28 24 3 2 2 2 2 2 2 2 2 2 2 2 2 3 24 0 0 0 0 0 0 0 0 0 0 0 0 0 0 0 0 0 0 0 0 0 0 0 0 0 0 0 0 0 0 0 0
24 28 28 28 24 2 2 24 28 28 28 28 28 28 28 28 24 3 2 3 3 3 3 3 3 3 3 3 3 2 3 24 0 0 0 0 0 0 0 0 0 0 0 0 0 0 0 0 0 0 0 0 0 0 0 0 0 0 0 0 0 0 0 0
24 28 28 28 24 3 3 24 28 28 28 28 28 28 28 28 24 3 2 3 2 2 2 2 2 2 2 2 3 2 3 24 0 0 0 0 0 0 0 0 0 0 0 0 0 0 0 0 0 0 0 0 0 0 0 0 0 0 0 0 0 0 0 0
24 28 28 28 24 2 2 24 28 28 28 28 28 28 28 28 24 3 2 3 2 3 3 3 3 3 3 2 3 2 3 24 0 0 0 0 0 0 0 0 0 0 0 0 0 0 0 0 0 0 0 0 0 0 0 0 0 0 0 0 0 0 0 0
24 28 28 28 24 3 3 24 24 24 24 24 24 24 24 24 24 3 2 3 2 3 2 2 2 2 3 2 3 2 3 24 0 0 0 0 0 0 0 0 0 0 0 0 0 0 0 0 0 0 0 0 0 0 0 0 0 0 0 0 0 0 0 0
24 28 28 28 24 2 2 3 2 3 2 3 2 3 2 3 52 3 2 3 2 3 2 3 3 2 3 2 3 2 3 24 0 0 0 0 0 0 0 0 0 0 0 0 0 0 0 0 0 0 0 0 0 0 0 0 0 0 0 0 0 0 0 0
24 28 28 28 24 4 2 3 2 3 2 3 2 3 2 3 53 3 2 3 2 3 2 3 3 2 3 2 3 2 3 24 0 0 0 0 0 0 0 0 0 0 0 0 0 0 0 0 0 0 0 0 0 0 0 0 0 0 0 0 0 0 0 0
24 28 28 28 24 24 24 24 24 24 24 24 24 24 24 24 24 3 2 3 2 3 2 2 2 2 3 2 3 2 3 24 0 0 0 0 0 0 0 0 0 0 0 0 0 0 0 0 0 0 0 0 0 0 0 0 0 0 0 0 0 0 0 0
24 28 28 28 28 28 28 28 28 28 28 28 28 28 28 28 24 3 2 3 2 3 3 3 3 3 3 2 3 2 3 24 0 0 0 0 0 0 0 0 0 0 0 0 0 0 0 0 0 0 0 0 0 0 0 0 0 0 0 0 0 0 0 0
24 28 28 28 28 28 28 28 28 28 28 28 28 28 28 28 24 3 2 3 2 2 2 2 2 2 2 2 3 2 3 24 0 0 0 0 0 0 0 0 0 0 0 0 0 0 0 0 0 0 0 0 0 0 0 0 0 0 0 0 0 0 0 0
24 28 28 28 28 28 28 28 24 24 24 24 24 24 24 24 24 3 2 3 3 3 3 3 3 3 3 3 3 2 3 24 0 0 0 0 0 0 0 0 0 0 0 0 0 0 0 0 0 0 0 0 0 0 0 0 0 0 0 0 0 0 0 0
24 28 28 28 28 28 28 28 24 4 2 3 2 3 2 3 52 3 2 2 2 2 2 2 2 2 2 2 2 2 3 24 0 0 0 0 0 0 0 0 0 0 0 0 0 0 0 0 0 0 0 0 0 0 0 0 0 0 0 0 0 0 0 0
24 28 28 28 28 28 28 28 24 2 2 3 2 3 2 3 53 3 3 3 3 3 3 3 3 3 3 3 3 3 3 24 0 0 0 0 0 0 0 0 0 0 0 0 0 0 0 0 0 0 0 0 0 0 0 0 0 0 0 0 0 0 0 0
24 28 28 28 28 28 28 28 24 3 3 24 24 24 24 24 24 24 24 24 24 24 24 24 24 24 24 24 24 24 24 24 0 0 0 0 0 0 0 0 0 0 0 0 0 0 0 0 0 0 0 0 0 0 0 0 0 0 0 0 0 0 0 0
24 24 24 24 24 24 24 24 24 48 49 24 24 24 24 24 28 28 28 28 28 28 28 28 28 28 28 28 28 28 28 28 24 24 24 24 24 24 24 24 24 24 24 24 24 24 24 24 0 0 0 0 0 0 0 0 0 0 0 0 0 0 0 0
24 3 3 3 3 3 3 3 3 3 3 3 3 3 3 24 28 28 28 28 28 28 28 28 28 28 28 28 28 28 28 28 24 3 3 2 2 3 3 2 2 3 3 2 2 3 3 24 0 0 0 0 0 0 0 0 0 0 0 0 0 0 0 0
24 3 3 3 3 3 3 3 3 3 3 3 3 3 3 24 28 28 28 28 28 28 28 28 28 28 28 28 28 28 28 28 24 1 1 3 3 1 1 3 3 1 1 3 3 1 1 24 0 0 0 0 0 0 0 0 0 0 0 0 0 0 0 0
24 3 3 24 24 24 3 3 3 3 24 24 24 3 3 24 28 28 28 28 28 28 28 28 28 28 28 28 28 28 28 28 24 3 3 2 2 3 3 2 2 3 3 2 2 3 3 24 0 0 0 0 0 0 0 0 0 0 0 0 0 0 0 0
24 3 3 24 28 24 3 3 3 3 24 28 24 3 3 24 28 28 28 28 28 28 28 28 24 24 24 24 24 24 24 24 24 1 1 3 3 1 1 3 3 1 1 3 3 1 1 24 0 0 0 0 0 0 0 0 0 0 0 0 0 0 0 0
24 3 3 24 24 24 3 3 3 3 24 24 24 3 3 24 28 28 28 28 28 28 28 28 24 2 2 3 2 3 2 3 52 3 3 2 2 3 3 2 2 3 3 2 2 3 3 24 0 0 0 0 0 0 0 0 0 0 0 0 0 0 0 0
24 3 3 3 3 3 3 3 3 3 3 3 3 3 3 24 28 28 28 28 28 28 28 28 24 2 2 3 2 3 2 3 53 1 1 3 3 1 1 3 3 1 1 3 3 1 1 24 0 0 0 0 0 0 0 0 0 0 0 0 0 0 0 0
24 3 3 3 3 3 3 3 3 3 3 3 3 3 3 24 28 28 28 28 28 28 28 28 24 3 3 24 24 24 24 24 24 3 3 2 2 3 3 2 2 3 3 2 2 3 3 24 0 0 0 0 0 0 0 0 0 0 0 0 0 0 0 0
24 3 3 3 3 3 3 3 3 3 3 3 3 3 3 24 28 28 28 28 28 28 28 28 24 2 2 24 28 28 28 28 24 1 1 3 3 1 1 3 3 1 1 3 3 1 1 24 0 0 0 0 0 0 0 0 0 0 0 0 0 0 0 0
24 3 3 3 3 3 3 3 3 3 3 3 3 3 3 24 28 28 28 28 28 28 28 28 24 3 3 24 28 28 28 28 24 3 3 2 2 3 3 2 2 3 3 2 2 3 3 24 0 0 0 0 0 0 0 0 0 0 0 0 0 0 0 0
24 3 3 24 24 24 3 3 3 3 3 24 24 24 3 24 28 28 28 28 28 28 28 28 24 2 2 24 28 28 28 28 24 1 1 3 3 1 1 3 3 1 1 3 3 1 1 24 0 0 0 0 0 0 0 0 0 0 0 0 0 0 0 0
24 3 3 24 28 24 3 3 3 3 3 24 28 24 3 24 28 28 28 28 28 28 28 28 24 3 3 24 28 28 28 28 24 3 3 2 2 3 3 2 2 3 3 2 2 3 3 24 0 0 0 0 0 0 0 0 0 0 0 0 0 0 0 0
24 3 3 24 24 24 3 3 3 3 3 24 24 24 3 24 28 28 28 28 28 28 28 28 24 2 2 24 28 28 28 28 24 1 1 3 3 1 1 3 3 1 1 3 3 1 1 24 0 0 0 0 0 0 0 0 0 0 0 0 0 0 0 0
24 3 3 3 3 3 3 3 3 3 3 3 3 3 3 24 28 28 28 28 28 28 28 28 24 3 3 24 28 28 28 28 24 3 3 2 2 3 3 2 2 3 3 2 2 3 3 24 0 0 0 0 0 0 0 0 0 0 0 0 0 0 0 0
24 3 3 3 3 3 3 3 3 3 3 3 3 3 3 24 28 28 28 28 28 28 28 28 24 2 2 24 28 28 28 28 24 1 1 3 3 1 1 3 3 1 1 3 3 1 1 24 0 0 0 0 0 0 0 0 0 0 0 0 0 0 0 0
24 24 24 24 24 24 24 50 51 24 24 24 24 24 24 24 28 28 28 28 28 28 28 28 24 3 3 24 28 28 28 28 24 24 24 24 24 24 24 50 51 24 24 24 24 24 24 24 0 0 0 0 0 0 0 0 0 0 0 0 0 0 0 0
24 28 28 28 28 28 24 3 3 24 28 28 28 28 28 28 24 24 24 24 24 24 24 24 24 48 49 24 24 24 24 24 28 28 28 28 28 28 24 3 3 24 28 28 28 28 28 28 24 24 24 24 24 24 24 24 24 24 24 24 24 24 24 24
24 28 28 28 28 28 24 2 2 24 28 28 28 28 28 28 24 3 3 3 3 3 3 3 3 3 3 3 3 3 3 24 28 28 28 28 28 28 24 2 2 24 28 28 28 28 28 28 24 3 3 3 3 3 3 3 3 3 3 3 3 3 3 24
24 28 28 28 28 28 24 3 3 24 28 28 28 28 28 28 24 3 3 3 3 3 3 3 3 3 3 3 3 3 3 24 28 28 28 28 28 28 24 3 3 24 28 28 28 28 28 28 24 3 3 3 3 3 3 3 3 3 3 3 3 3 3 24
24 28 28 28 28 28 24 2 2 24 28 28 28 28 28 28 24 3 3 3 3 3 3 3 3 3 3 3 3 3 3 24 28 28 28 28 28 28 24 2 2 24 28 28 28 28 28 28 24 3 3 3 3 3 3 3 3 3 3 3 3 3 3 24
24 28 28 28 28 28 24 3 3 24 28 28 28 28 28 28 24 3 3 3 3 3 3 3 3 3 3 3 3 3 3 24 28 28 28 28 28 28 24 3 3 24 24 24 24 24 24 24 24 3 3 3 3 3 3 3 3 3 3 3 3 3 3 24
24 28 28 28 28 28 24 2 2 24 28 28 28 28 28 28 24 3 3 3 3 3 3 3 3 3 3 3 3 3 3 24 28 28 28 28 28 28 24 2 2 3 2 3 2 3 2 3 52 3 3 3 3 3 3 3 3 3 3 3 3 3 3 24
24 28 28 28 28 28 24 3 3 24 28 28 28 28 28 28 24 3 3 3 3 24 24 24 24 24 24 3 3 3 3 24 28 28 28 28 28 28 24 2 2 3 2 3 2 3 2 3 53 3 3 3 3 3 3 3 3 3 3 3 3 3 3 24
24 28 28 28 28 28 24 2 2 24 28 28 28 28 28 28 24 3 3 3 3 24 28 28 28 28 24 3 3 3 3 24 28 28 28 28 28 28 24 24 24 24 24 24 24 24 24 24 24 3 3 3 3 3 3 3 3 3 3 3 3 3 3 24
24 28 28 28 28 28 24 3 3 24 28 28 28 28 28 28 24 3 3 3 3 24 28 28 28 28 24 3 3 3 3 24 28 28 28 28 28 28 28 28 28 28 28 28 28 28 28 28 24 3 3 3 3 3 3 3 3 3 3 3 3 3 3 24
24 28 28 28 28 28 24 2 2 24 28 28 28 28 28 28 24 3 3 3 3 24 24 24 24 24 24 3 3 3 3 24 28 28 28 28 28 28 28 28 28 28 28 28 28 28 28 28 24 3 3 3 3 3 3 3 3 3 3 3 3 3 3 24
24 28 28 28 28 28 24 3 3 24 24 24 24 24 24 24 24 3 3 3 3 3 3 3 3 3 3 3 3 3 3 24 28 28 28 28 28 28 28 28 28 28 28 28 28 28 28 28 24 3 3 3 3 3 3 3 3 3 3 3 3 3 3 24
24 28 28 28 28 28 24 2 2 3 2 3 2 3 2 3 52 3 3 3 3 3 3 3 3 3 3 3 3 3 3 24 28 28 28 28 28 28 28 28 28 28 28 28 28 28 28 28 24 3 3 3 3 3 3 3 3 3 3 3 3 3 3 24
24 28 28 28 28 28 24 2 2 3 2 3 2 3 2 3 53 3 3 3 3 3 3 3 3 3 3 3 3 3 3 24 28 28 28 28 28 28 28 28 28 28 28 28 28 28 28 28 24 3 3 3 3 3 3 3 3 3 3 3 3 3 3 24
24 28 28 28 28 28 24 24 24 24 24 24 24 24 24 24 24 3 3 3 3 3 3 3 3 3 3 3 3 3 3 24 28 28 28 28 28 28 28 28 28 28 28 28 28 28 28 28 24 3 3 3 3 3 3 3 3 3 3 3 3 3 3 24
24 28 28 28 28 28 28 28 28 28 28 28 28 28 28 28 24 3 3 3 3 3 3 3 3 3 3 3 3 3 3 24 28 28 28 28 28 28 28 28 28 28 28 28 28 28 28 28 24 3 3 3 3 3 3 3 3 3 3 3 3 3 3 24
24 24 24 24 24 24 24 24 24 24 24 24 24 24 24 24 24 24 24 24 24 24 24 24 24 24 24 24 24 24 24 24 24 24 24 24 24 24 24 24 24 24 24 24 24 24 24 24 24 24 24 24 24 24 24 24 24 24 24 24 24 24 24 24
