72 72 72 72 72 72 72 72 72 72 72 72 72 72 72 72 0 0 0 0 0 0 0 0 0 0 0 0 0 0 0 0 0 0 0 0 0 0 0 0 0 0 0 0 0 0 0 0 0 0 0 0 0 0 0 0 0 0 0 0 0 0 0 0 
72 75 75 75 75 75 75 75 75 75 75 75 75 75 75 72 0 0 0 0 0 0 0 0 0 0 0 0 0 0 0 0 0 0 0 0 0 0 0 0 0 0 0 0 0 0 0 0 0 0 0 0 0 0 0 0 0 0 0 0 0 0 0 0 
72 75 75 75 75 75 75 75 75 75 75 75 75 75 75 72 0 0 0 0 0 0 0 0 0 0 0 0 0 0 0 0 0 0 0 0 0 0 0 0 0 0 0 0 0 0 0 0 0 0 0 0 0 0 0 0 0 0 0 0 0 0 0 0 
72 75 75 75 75 75 75 75 75 75 75 75 75 75 75 72 0 0 0 0 0 0 0 0 0 0 0 0 0 0 0 0 0 0 0 0 0 0 0 0 0 0 0 0 0 0 0 0 0 0 0 0 0 0 0 0 0 0 0 0 0 0 0 0 
72 75 75 75 75 75 75 75 75 75 75 75 75 75 75 72 0 0 0 0 0 0 0 0 0 0 0 0 0 0 0 0 0 0 0 0 0 0 0 0 0 0 0 0 0 0 0 0 0 0 0 0 0 0 0 0 0 0 0 0 0 0 0 0 
72 75 75 75 75 75 10 10 10 10 75 75 75 75 75 72 0 0 0 0 0 0 0 0 0 0 0 0 0 0 0 0 0 0 0 0 0 0 0 0 0 0 0 0 0 0 0 0 0 0 0 0 0 0 0 0 0 0 0 0 0 0 0 0 
72 75 75 75 75 75 10 75 75 10 75 75 75 75 75 72 0 0 0 0 0 0 0 0 0 0 0 0 0 0 0 0 0 0 0 0 0 0 0 0 0 0 0 0 0 0 0 0 0 0 0 0 0 0 0 0 0 0 0 0 0 0 0 0 
72 75 75 75 75 75 75 75 75 10 75 75 75 75 75 72 0 0 0 0 0 0 0 0 0 0 0 0 0 0 0 0 0 0 0 0 0 0 0 0 0 0 0 0 0 0 0 0 0 0 0 0 0 0 0 0 0 0 0 0 0 0 0 0 
72 75 75 75 75 75 75 10 10 10 75 75 75 75 75 72 0 0 0 0 0 0 0 0 0 0 0 0 0 0 0 0 0 0 0 0 0 0 0 0 0 0 0 0 0 0 0 0 0 0 0 0 0 0 0 0 0 0 0 0 0 0 0 0 
72 75 75 75 75 75 75 75 75 10 75 75 75 75 75 72 0 0 0 0 0 0 0 0 0 0 0 0 0 0 0 0 0 0 0 0 0 0 0 0 0 0 0 0 0 0 0 0 0 0 0 0 0 0 0 0 0 0 0 0 0 0 0 0 
72 75 75 75 75 75 10 75 75 10 75 75 75 75 75 72 0 0 0 0 0 0 0 0 0 0 0 0 0 0 0 0 0 0 0 0 0 0 0 0 0 0 0 0 0 0 0 0 0 0 0 0 0 0 0 0 0 0 0 0 0 0 0 0 
72 75 75 75 75 75 10 10 10 10 75 75 75 75 75 72 0 0 0 0 0 0 0 0 0 0 0 0 0 0 0 0 0 0 0 0 0 0 0 0 0 0 0 0 0 0 0 0 0 0 0 0 0 0 0 0 0 0 0 0 0 0 0 0 
72 75 75 75 75 75 75 75 75 75 75 75 75 75 75 72 0 0 0 0 0 0 0 0 0 0 0 0 0 0 0 0 0 0 0 0 0 0 0 0 0 0 0 0 0 0 0 0 0 0 0 0 0 0 0 0 0 0 0 0 0 0 0 0 
72 75 75 75 75 75 75 75 75 75 75 75 75 75 75 72 0 0 0 0 0 0 0 0 0 0 0 0 0 0 0 0 0 0 0 0 0 0 0 0 0 0 0 0 0 0 0 0 0 0 0 0 0 0 0 0 0 0 0 0 0 0 0 0 
72 75 75 75 75 75 75 75 75 75 75 75 75 75 75 72 0 0 0 0 0 0 0 0 0 0 0 0 0 0 0 0 0 0 0 0 0 0 0 0 0 0 0 0 0 0 0 0 0 0 0 0 0 0 0 0 0 0 0 0 0 0 0 0 
72 72 72 72 72 72 72 37 38 72 72 72 72 72 72 72 0 0 0 0 0 0 0 0 0 0 0 0 0 0 0 0 0 0 0 0 0 0 0 0 0 0 0 0 0 0 0 0 0 0 0 0 0 0 0 0 0 0 0 0 0 0 0 0 
72 6 6 6 6 6 72 70 70 72 6 6 6 6 6 6 72 72 72 72 72 72 72 72 72 72 72 72 72 72 72 72 0 0 0 0 0 0 0 0 0 0 0 0 0 0 0 0 0 0 0 0 0 0 0 0 0 0 0 0 0 0 0 0 
72 6 6 6 6 6 72 75 75 72 6 6 6 6 6 6 72 75 75 11 75 75 11 75 75 11 75 75 11 75 75 72 0 0 0 0 0 0 0 0 0 0 0 0 0 0 0 0 0 0 0 0 0 0 0 0 0 0 0 0 0 0 0 0 
72 6 6 6 6 6 72 70 70 72 6 6 6 6 6 6 72 75 75 11 75 75 11 75 75 11 75 75 11 75 75 72 0 0 0 0 0 0 0 0 0 0 0 0 0 0 0 0 0 0 0 0 0 0 0 0 0 0 0 0 0 0 0 0 
72 6 6 6 6 6 72 75 75 72 6 6 6 6 6 6 72 11 11 11 11 11 11 11 11 11 11 11 11 11 11 72 0 0 0 0 0 0 0 0 0 0 0 0 0 0 0 0 0 0 0 0 0 0 0 0 0 0 0 0 0 0 0 0 
72 6 6 6 6 6 72 70 70 72 72 72 72 72 72 72 72 75 75 11 75 75 11 75 75 11 75 75 11 75 75 72 0 0 0 0 0 0 0 0 0 0 0 0 0 0 0 0 0 0 0 0 0 0 0 0 0 0 0 0 0 0 0 0 
72 6 6 6 6 6 72 75 75 70 75 70 75 70 75 70 75 75 75 11 75 75 11 75 75 11 75 75 11 75 75 72 0 0 0 0 0 0 0 0 0 0 0 0 0 0 0 0 0 0 0 0 0 0 0 0 0 0 0 0 0 0 0 0 
72 6 6 6 6 6 72 70 75 70 75 70 75 70 75 70 75 11 11 11 11 11 11 11 11 11 11 11 11 11 11 72 0 0 0 0 0 0 0 0 0 0 0 0 0 0 0 0 0 0 0 0 0 0 0 0 0 0 0 0 0 0 0 0 
72 6 6 6 6 6 72 72 72 72 72 72 72 72 72 72 72 75 75 11 75 75 11 75 75 11 75 75 11 75 75 72 0 0 0 0 0 0 0 0 0 0 0 0 0 0 0 0 0 0 0 0 0 0 0 0 0 0 0 0 0 0 0 0 
72 6 6 6 6 6 6 6 6 6 6 6 6 6 6 6 72 75 75 11 75 75 11 75 75 11 75 75 11 75 75 72 0 0 0 0 0 0 0 0 0 0 0 0 0 0 0 0 0 0 0 0 0 0 0 0 0 0 0 0 0 0 0 0 
72 6 6 6 6 6 6 6 6 6 6 6 6 6 6 6 72 11 11 11 11 11 11 11 11 11 11 11 11 11 11 72 0 0 0 0 0 0 0 0 0 0 0 0 0 0 0 0 0 0 0 0 0 0 0 0 0 0 0 0 0 0 0 0 
72 6 6 6 6 6 72 72 72 72 72 72 72 72 72 72 72 75 75 11 75 75 11 75 75 11 75 75 11 75 75 72 0 0 0 0 0 0 0 0 0 0 0 0 0 0 0 0 0 0 0 0 0 0 0 0 0 0 0 0 0 0 0 0 
72 6 6 6 6 6 72 70 75 70 75 70 75 70 75 70 41 75 75 11 75 75 11 75 75 11 75 75 11 75 75 72 0 0 0 0 0 0 0 0 0 0 0 0 0 0 0 0 0 0 0 0 0 0 0 0 0 0 0 0 0 0 0 0 
72 6 6 6 6 6 72 75 75 70 75 70 75 70 75 70 42 11 11 11 11 11 11 11 11 11 11 11 11 11 11 72 0 0 0 0 0 0 0 0 0 0 0 0 0 0 0 0 0 0 0 0 0 0 0 0 0 0 0 0 0 0 0 0 
72 6 6 6 6 6 72 70 70 72 72 72 72 72 72 72 72 75 75 11 75 75 11 75 75 11 75 75 11 75 75 72 0 0 0 0 0 0 0 0 0 0 0 0 0 0 0 0 0 0 0 0 0 0 0 0 0 0 0 0 0 0 0 0 
72 6 6 6 6 6 72 75 75 72 6 6 6 6 6 6 72 75 75 11 75 75 11 75 75 11 75 75 11 75 75 72 0 0 0 0 0 0 0 0 0 0 0 0 0 0 0 0 0 0 0 0 0 0 0 0 0 0 0 0 0 0 0 0 
72 6 6 6 6 6 72 70 70 72 6 6 6 6 6 6 72 72 72 72 72 72 72 72 72 72 72 72 72 72 72 72 0 0 0 0 0 0 0 0 0 0 0 0 0 0 0 0 0 0 0 0 0 0 0 0 0 0 0 0 0 0 0 0 
72 72 72 72 72 72 72 75 75 72 72 72 72 72 72 72 6 6 6 6 6 6 6 6 6 6 6 6 6 6 6 6 72 72 72 72 72 72 72 72 72 72 72 72 72 72 72 72 0 0 0 0 0 0 0 0 0 0 0 0 0 0 0 0 
72 72 72 72 72 75 75 75 75 75 75 72 72 72 72 72 6 6 6 6 6 6 6 6 6 6 6 6 6 6 6 6 72 75 75 75 75 75 75 75 75 75 75 75 75 75 75 72 0 0 0 0 0 0 0 0 0 0 0 0 0 0 0 0 
72 72 72 72 72 75 75 75 75 75 75 72 72 72 72 72 6 6 6 6 6 6 6 6 6 6 6 6 6 6 6 6 72 75 75 75 75 75 75 75 75 75 75 75 75 75 75 72 0 0 0 0 0 0 0 0 0 0 0 0 0 0 0 0 
72 72 72 72 72 75 75 75 75 75 75 72 72 72 72 72 6 6 6 6 6 6 6 6 6 6 6 6 6 6 6 6 72 75 75 75 75 75 72 72 72 72 72 72 72 75 75 72 0 0 0 0 0 0 0 0 0 0 0 0 0 0 0 0 
72 72 72 72 75 75 75 75 75 75 75 75 72 72 72 72 6 6 6 6 6 6 6 6 72 72 72 72 72 72 72 72 72 75 75 75 75 75 72 6 6 6 6 6 72 75 75 72 0 0 0 0 0 0 0 0 0 0 0 0 0 0 0 0 
72 75 75 75 75 75 75 75 75 75 75 75 75 75 75 72 6 6 6 6 6 6 6 6 72 70 75 70 75 70 75 70 75 75 75 75 75 75 72 6 6 6 6 6 72 75 75 72 0 0 0 0 0 0 0 0 0 0 0 0 0 0 0 0 
72 75 75 75 75 75 75 75 75 75 75 75 75 75 75 72 6 6 6 6 6 6 6 6 72 75 75 70 75 70 75 70 75 75 75 75 75 75 72 72 72 72 6 6 72 75 75 72 0 0 0 0 0 0 0 0 0 0 0 0 0 0 0 0 
72 75 75 75 75 75 75 75 75 75 75 75 75 75 75 72 6 6 6 6 6 6 6 6 72 70 70 72 72 72 72 72 72 75 75 75 75 75 75 75 75 72 6 6 72 75 75 72 0 0 0 0 0 0 0 0 0 0 0 0 0 0 0 0 
72 75 75 75 75 75 75 75 75 75 75 75 75 75 75 72 6 6 6 6 6 6 6 6 72 75 75 72 6 6 6 6 72 75 75 75 75 75 75 75 75 72 6 6 72 75 75 72 0 0 0 0 0 0 0 0 0 0 0 0 0 0 0 0 
72 75 75 75 75 75 75 75 75 75 75 75 75 75 75 72 6 6 6 6 6 6 6 6 72 70 70 72 6 6 6 6 72 75 75 75 75 75 75 75 75 72 72 72 72 75 75 72 0 0 0 0 0 0 0 0 0 0 0 0 0 0 0 0 
72 75 75 75 75 75 75 75 75 75 75 75 75 75 75 72 6 6 6 6 6 6 6 6 72 75 75 72 6 6 6 6 72 75 75 75 75 75 75 75 75 75 75 75 75 75 75 72 0 0 0 0 0 0 0 0 0 0 0 0 0 0 0 0 
72 72 72 72 75 75 75 75 75 75 75 75 72 72 72 72 6 6 6 6 6 6 6 6 72 70 70 72 6 6 6 6 72 75 75 75 75 75 75 75 75 75 75 75 75 75 75 72 0 0 0 0 0 0 0 0 0 0 0 0 0 0 0 0 
72 72 72 72 72 75 75 75 75 75 75 72 72 72 72 72 6 6 6 6 6 6 6 6 72 75 75 72 6 6 6 6 72 75 75 75 75 75 75 75 75 75 75 75 75 75 75 72 0 0 0 0 0 0 0 0 0 0 0 0 0 0 0 0 
72 72 72 72 72 75 75 75 75 75 75 72 72 72 72 72 6 6 6 6 6 6 6 6 72 70 70 72 6 6 6 6 72 75 75 75 75 75 75 75 75 75 75 75 75 75 75 72 0 0 0 0 0 0 0 0 0 0 0 0 0 0 0 0 
72 72 72 72 72 75 75 75 75 75 75 72 72 72 72 72 6 6 6 6 6 6 6 6 72 75 75 72 6 6 6 6 72 75 75 75 75 75 75 75 75 75 75 75 75 75 75 72 0 0 0 0 0 0 0 0 0 0 0 0 0 0 0 0 
72 72 72 72 72 72 72 37 38 72 72 72 72 72 72 72 6 6 6 6 6 6 6 6 72 70 70 72 6 6 6 6 72 72 72 72 72 37 38 72 72 72 72 72 72 72 72 72 0 0 0 0 0 0 0 0 0 0 0 0 0 0 0 0 
72 6 6 6 6 6 72 70 70 72 6 6 6 6 6 6 72 72 72 72 72 72 72 72 72 49 50 72 72 72 72 72 6 6 6 6 72 70 70 72 6 6 6 6 6 6 6 6 72 72 72 72 72 72 72 72 72 72 72 72 72 72 72 72 
72 6 6 6 6 6 72 75 75 72 6 6 6 6 6 6 72 75 11 75 11 75 11 75 75 11 75 11 75 11 75 72 6 6 6 6 72 75 75 72 6 6 6 6 6 6 6 6 72 6 6 6 72 72 72 75 75 72 72 72 6 6 6 72 
72 6 6 6 6 6 72 70 70 72 6 6 6 6 6 6 72 11 11 75 11 75 11 75 75 11 75 11 75 11 11 72 6 6 6 6 72 70 70 72 6 6 6 6 6 6 6 6 72 6 72 72 72 72 72 49 50 72 72 72 72 72 6 72 
72 6 6 6 6 6 72 75 75 72 6 6 6 6 6 6 72 75 75 75 11 75 11 75 75 11 75 11 75 75 75 72 6 6 6 6 72 75 75 72 6 6 6 6 6 6 6 6 72 6 72 75 75 75 75 75 75 75 75 75 75 72 6 72 
72 6 6 6 6 6 72 70 70 72 72 72 72 72 72 72 72 11 11 11 11 75 11 75 75 11 75 11 11 11 11 72 6 6 6 6 72 70 70 72 6 6 6 6 6 6 6 6 72 72 72 75 75 75 75 75 75 75 75 75 75 72 72 72 
72 6 6 6 6 6 72 75 75 70 75 70 75 70 75 70 75 75 75 75 75 75 11 75 75 11 75 75 75 75 75 72 6 6 6 6 72 75 75 72 6 6 6 6 6 6 6 6 72 75 75 75 75 75 75 75 75 75 75 75 75 75 75 72 
72 6 6 6 6 6 72 70 75 70 75 70 75 70 75 70 75 11 11 11 11 11 11 75 75 11 11 11 11 11 11 72 6 6 6 6 72 70 70 72 6 6 6 6 6 6 6 6 72 75 75 75 75 75 75 75 75 75 75 75 75 75 75 72 
72 6 6 6 6 6 72 72 72 72 72 72 72 72 72 72 72 75 75 75 75 75 75 11 11 75 75 75 75 75 75 72 6 6 6 6 72 75 75 72 6 6 6 6 6 6 6 6 72 75 75 75 75 75 75 75 75 75 75 75 75 75 75 72 
72 6 6 6 6 6 6 6 6 6 6 6 6 6 6 6 72 75 75 75 75 75 75 11 11 75 75 75 75 75 75 72 6 6 6 6 72 70 70 72 72 72 72 72 72 72 72 72 72 75 75 75 75 75 75 75 75 75 75 75 75 75 75 72 
72 6 6 6 6 6 6 6 6 6 6 6 6 6 6 6 72 11 11 11 11 11 11 75 75 11 11 11 11 11 11 72 6 6 6 6 72 75 75 70 75 70 75 70 75 70 75 70 75 75 75 75 75 75 75 75 75 75 75 75 75 75 75 72 
72 6 6 6 6 6 6 6 6 6 6 6 6 6 6 6 72 75 75 75 75 75 11 75 75 11 75 75 75 75 75 72 6 6 6 6 72 70 75 70 75 70 75 70 75 70 75 70 75 75 75 75 75 75 75 75 75 75 75 75 75 75 75 72 
72 6 6 6 6 6 6 6 6 6 6 6 6 6 6 6 72 11 11 11 11 75 11 75 75 11 75 11 11 11 11 72 6 6 6 6 72 72 72 72 72 72 72 72 72 72 72 72 72 72 72 75 75 75 75 75 75 75 75 75 75 72 72 72 
72 6 6 6 6 6 6 6 6 6 6 6 6 6 6 6 72 75 75 75 11 75 11 75 75 11 75 11 75 75 75 72 6 6 6 6 6 6 6 6 6 6 6 6 6 6 6 6 72 6 72 75 75 75 75 75 75 75 75 75 75 72 6 72 
72 6 6 6 6 6 6 6 6 6 6 6 6 6 6 6 72 11 11 75 11 75 11 75 75 11 75 11 75 11 11 72 6 6 6 6 6 6 6 6 6 6 6 6 6 6 6 6 72 6 72 72 72 75 75 75 75 75 75 72 72 72 6 72 
72 6 6 6 6 6 6 6 6 6 6 6 6 6 6 6 72 75 11 75 11 75 11 75 75 11 75 11 75 11 75 72 6 6 6 6 6 6 6 6 6 6 6 6 6 6 6 6 72 6 6 6 72 75 75 75 75 75 75 72 6 6 6 72 
72 72 72 72 72 72 72 72 72 72 72 72 72 72 72 72 72 72 72 72 72 72 72 72 72 72 72 72 72 72 72 72 72 72 72 72 72 72 72 72 72 72 72 72 72 72 72 72 72 72 72 72 72 72 72 37 38 72 72 72 72 72 72 72 
