16 16 16 16 16 16 16 16 16 16 16 16 16 16 16 16 16 16 16 16 16 16 16 16 16 16 16 16 16 16 16 16 16 16 16 16 16 16 16 16 16 16 16 16 16 16 16 16 0 0 0 0 0 0 0 0 0 0 0 0 0 0 0 0 
16 41 41 41 41 41 41 41 41 41 41 41 41 41 41 16 42 42 42 42 42 42 42 42 42 42 42 42 42 42 42 42 16 12 41 41 41 12 41 41 41 12 41 41 41 12 41 16 0 0 0 0 0 0 0 0 0 0 0 0 0 0 0 0 
16 41 41 41 41 41 41 41 41 41 41 41 41 41 41 16 42 42 42 42 42 42 42 42 42 42 42 42 42 42 42 42 16 41 12 41 41 41 12 41 41 41 12 41 41 41 12 16 0 0 0 0 0 0 0 0 0 0 0 0 0 0 0 0 
16 41 41 41 41 41 41 41 41 41 41 41 41 41 41 16 42 42 42 42 42 42 42 42 42 42 42 42 42 42 42 42 16 41 41 12 41 41 41 12 41 41 41 12 41 41 41 16 0 0 0 0 0 0 0 0 0 0 0 0 0 0 0 0 
16 41 41 41 41 41 41 41 41 41 41 41 41 41 41 16 42 42 42 42 42 42 42 42 42 42 42 42 42 42 42 42 16 41 41 41 12 41 41 41 12 41 41 41 12 41 41 16 0 0 0 0 0 0 0 0 0 0 0 0 0 0 0 0 
16 41 41 41 41 41 12 12 12 12 41 41 41 41 41 16 42 42 42 42 42 42 42 42 42 42 42 42 42 42 42 42 16 12 41 41 41 12 41 41 41 12 41 41 41 12 41 16 0 0 0 0 0 0 0 0 0 0 0 0 0 0 0 0 
16 41 41 41 41 41 12 41 41 12 41 41 41 41 41 16 42 42 42 42 42 42 42 42 42 42 42 42 42 42 42 42 16 41 12 41 41 41 12 41 41 41 12 41 41 41 12 16 0 0 0 0 0 0 0 0 0 0 0 0 0 0 0 0 
16 41 41 41 41 41 41 41 41 12 41 41 41 41 41 16 42 42 42 42 42 42 42 42 42 42 42 42 42 42 42 42 16 41 41 12 41 41 41 12 41 41 41 12 41 41 41 16 0 0 0 0 0 0 0 0 0 0 0 0 0 0 0 0 
16 41 41 41 41 41 12 12 12 12 41 41 41 41 41 16 42 42 42 42 42 42 16 16 16 16 16 16 16 16 16 16 16 41 41 41 12 41 41 41 12 41 41 41 12 41 41 16 0 0 0 0 0 0 0 0 0 0 0 0 0 0 0 0 
16 41 41 41 41 41 12 41 41 41 41 41 41 41 41 16 42 42 42 42 42 42 16 41 12 41 12 41 12 41 12 41 12 12 41 41 41 12 41 41 41 12 41 41 41 12 41 16 0 0 0 0 0 0 0 0 0 0 0 0 0 0 0 0 
16 41 41 41 41 41 12 41 41 41 41 41 41 41 41 16 42 42 42 42 42 42 16 12 12 41 12 41 12 41 12 41 12 41 12 41 41 41 12 41 41 41 12 41 41 41 12 16 0 0 0 0 0 0 0 0 0 0 0 0 0 0 0 0 
16 41 41 41 41 41 12 12 12 12 41 41 41 41 41 16 42 42 42 42 42 42 16 41 41 16 16 16 16 16 16 16 16 41 41 12 41 41 41 12 41 41 41 12 41 41 41 16 0 0 0 0 0 0 0 0 0 0 0 0 0 0 0 0 
16 41 41 41 41 41 41 41 41 41 41 41 41 41 41 16 42 42 42 42 42 42 16 12 12 16 42 42 42 42 42 42 16 41 41 41 12 41 41 41 12 41 41 41 12 41 41 16 0 0 0 0 0 0 0 0 0 0 0 0 0 0 0 0 
16 41 41 41 41 41 41 41 41 41 41 41 41 41 41 16 42 42 42 42 42 42 16 41 41 16 42 42 42 42 42 42 16 12 41 41 41 12 41 41 41 12 41 41 41 12 41 16 0 0 0 0 0 0 0 0 0 0 0 0 0 0 0 0 
16 41 41 41 41 41 41 41 41 41 41 41 41 41 41 16 42 42 42 42 42 42 16 12 12 16 42 42 42 42 42 42 16 41 12 41 41 41 12 41 41 41 12 41 41 41 12 16 0 0 0 0 0 0 0 0 0 0 0 0 0 0 0 0 
16 16 16 16 16 16 16 43 44 16 16 16 16 16 16 16 42 42 42 42 42 42 16 41 41 16 42 42 42 42 42 42 16 16 16 16 16 16 16 16 43 44 16 16 16 16 16 16 0 0 0 0 0 0 0 0 0 0 0 0 0 0 0 0 
16 42 42 42 42 42 16 41 41 16 42 42 42 42 42 42 16 16 16 16 16 16 16 49 50 16 16 16 16 16 16 16 42 42 42 42 42 42 42 16 41 12 16 42 42 42 42 16 0 0 0 0 0 0 0 0 0 0 0 0 0 0 0 0 
16 42 42 42 42 42 16 12 12 16 42 42 42 42 42 42 16 16 16 41 41 41 41 41 41 41 41 41 41 16 16 16 42 42 42 42 42 42 42 16 12 41 16 42 42 42 42 16 0 0 0 0 0 0 0 0 0 0 0 0 0 0 0 0 
16 42 42 42 42 42 16 41 41 16 42 42 42 42 42 42 16 16 16 41 41 41 41 41 41 41 41 41 41 16 16 16 42 42 42 42 42 42 42 16 41 12 16 42 42 42 42 16 0 0 0 0 0 0 0 0 0 0 0 0 0 0 0 0 
16 42 42 42 42 42 16 12 12 16 42 42 42 42 42 42 16 41 41 41 41 41 41 40 40 41 41 41 41 41 41 16 42 42 42 42 42 42 42 16 12 41 16 42 42 42 42 16 0 0 0 0 0 0 0 0 0 0 0 0 0 0 0 0 
16 42 42 42 42 42 16 41 41 16 16 16 16 16 16 16 16 41 41 41 41 41 40 12 12 40 41 41 41 41 41 16 42 42 42 42 42 42 42 16 41 12 16 42 42 42 42 16 0 0 0 0 0 0 0 0 0 0 0 0 0 0 0 0 
16 42 42 42 42 42 16 12 12 41 12 41 12 41 12 41 12 41 41 41 41 40 12 40 40 12 40 41 41 41 41 16 42 42 42 42 42 42 42 16 12 41 16 42 42 42 42 16 0 0 0 0 0 0 0 0 0 0 0 0 0 0 0 0 
16 42 42 42 42 42 16 41 12 41 12 41 12 41 12 41 12 41 41 41 40 12 40 12 12 40 12 40 41 41 41 16 42 42 42 42 42 42 42 16 41 12 16 42 42 42 42 16 0 0 0 0 0 0 0 0 0 0 0 0 0 0 0 0 
16 42 42 42 42 42 16 16 16 16 16 16 16 16 16 16 16 41 41 40 12 40 12 40 40 12 40 12 40 41 41 16 42 42 42 42 42 42 42 16 12 41 16 42 42 42 42 16 0 0 0 0 0 0 0 0 0 0 0 0 0 0 0 0 
16 42 42 42 42 42 42 42 42 42 42 42 42 42 42 42 16 41 41 40 12 40 12 40 40 12 40 12 40 41 41 16 42 42 42 42 42 42 42 16 41 12 16 42 42 42 42 16 0 0 0 0 0 0 0 0 0 0 0 0 0 0 0 0 
16 42 42 42 42 42 42 42 42 42 42 42 42 42 42 42 16 41 41 41 40 12 40 12 12 40 12 40 41 41 41 16 42 42 42 42 42 42 42 16 12 41 16 42 42 42 42 16 0 0 0 0 0 0 0 0 0 0 0 0 0 0 0 0 
16 42 42 42 42 42 42 42 42 42 42 42 42 42 42 42 16 41 41 41 41 40 12 40 40 12 40 41 41 41 41 16 42 42 42 42 42 42 42 16 41 12 16 42 42 42 42 16 0 0 0 0 0 0 0 0 0 0 0 0 0 0 0 0 
16 42 42 42 42 42 42 42 42 42 42 42 42 42 42 42 16 41 41 41 41 41 40 12 12 40 41 41 41 41 41 16 42 42 42 42 42 42 42 16 12 41 16 42 42 42 42 16 0 0 0 0 0 0 0 0 0 0 0 0 0 0 0 0 
16 42 42 42 42 42 42 42 42 42 42 42 42 42 42 42 16 41 41 41 41 41 41 40 40 41 41 41 41 41 41 16 42 42 42 42 42 42 42 16 41 12 16 42 42 42 42 16 0 0 0 0 0 0 0 0 0 0 0 0 0 0 0 0 
16 42 42 42 42 42 42 42 42 42 42 42 42 42 42 42 16 16 16 41 41 41 41 41 41 41 41 41 41 16 16 16 42 42 42 42 42 42 42 16 12 41 16 42 42 42 42 16 0 0 0 0 0 0 0 0 0 0 0 0 0 0 0 0 
16 42 42 42 42 42 42 42 42 42 42 42 42 42 42 42 16 16 16 41 41 41 41 41 41 41 41 41 41 16 16 16 42 42 42 42 42 42 42 16 41 12 16 42 42 42 42 16 0 0 0 0 0 0 0 0 0 0 0 0 0 0 0 0 
16 42 42 42 42 42 42 42 42 42 42 42 42 42 42 42 16 16 16 16 16 16 16 16 16 16 16 16 16 16 16 16 42 42 42 42 42 42 42 16 12 41 16 42 42 42 42 16 0 0 0 0 0 0 0 0 0 0 0 0 0 0 0 0 
16 16 16 16 16 16 16 16 16 16 16 16 16 16 16 16 42 42 42 42 42 42 42 42 42 42 42 42 42 42 42 42 16 16 16 16 16 16 16 16 41 12 16 16 16 16 16 16 0 0 0 0 0 0 0 0 0 0 0 0 0 0 0 0 
16 12 41 41 41 41 41 41 41 41 41 41 41 41 12 16 42 42 42 42 42 42 42 42 42 42 42 42 42 42 42 42 16 41 12 12 12 12 12 12 12 12 12 12 12 12 41 16 0 0 0 0 0 0 0 0 0 0 0 0 0 0 0 0 
16 12 12 12 41 41 41 41 41 41 41 41 12 12 12 16 42 42 42 42 42 42 42 42 42 42 42 42 42 42 42 42 16 12 12 41 41 41 41 41 41 41 41 41 41 12 12 16 0 0 0 0 0 0 0 0 0 0 0 0 0 0 0 0 
16 16 16 12 41 41 41 41 41 41 41 41 12 16 16 16 42 42 42 42 42 42 42 42 42 42 42 42 42 42 42 42 16 12 41 41 41 41 41 41 41 41 41 41 41 41 12 16 0 0 0 0 0 0 0 0 0 0 0 0 0 0 0 0 
42 42 16 12 41 41 41 41 41 41 41 41 12 16 42 42 42 42 42 42 42 42 42 42 42 42 42 42 42 42 42 42 16 12 41 41 41 41 41 41 41 41 41 41 41 41 12 16 0 0 0 0 0 0 0 0 0 0 0 0 0 0 0 0 
42 42 16 12 41 41 41 41 41 41 41 41 12 16 42 42 42 42 42 42 42 42 42 42 42 42 42 42 42 42 42 42 16 12 41 41 41 41 41 41 41 41 41 41 41 41 12 16 0 0 0 0 0 0 0 0 0 0 0 0 0 0 0 0 
16 16 16 12 41 41 41 41 41 41 41 41 12 16 16 16 42 42 42 42 42 42 42 42 16 16 16 16 16 16 16 16 16 12 41 41 41 41 41 41 41 41 41 41 41 41 12 16 0 0 0 0 0 0 0 0 0 0 0 0 0 0 0 0 
16 12 12 12 41 41 41 41 41 41 41 41 12 12 12 16 42 42 42 42 42 42 42 42 16 41 12 41 12 41 12 41 45 12 41 41 41 41 41 41 41 41 41 41 41 41 12 16 0 0 0 0 0 0 0 0 0 0 0 0 0 0 0 0 
16 12 12 12 41 41 41 41 41 41 41 41 12 12 12 16 42 42 42 42 42 42 42 42 16 12 12 41 12 41 12 41 46 12 41 41 41 41 41 41 41 41 41 41 41 41 12 16 0 0 0 0 0 0 0 0 0 0 0 0 0 0 0 0 
16 16 16 12 41 41 41 41 41 41 41 41 12 16 16 16 42 42 42 42 42 42 42 42 16 41 41 16 16 16 16 16 16 12 41 41 41 41 41 41 41 41 41 41 41 41 12 16 0 0 0 0 0 0 0 0 0 0 0 0 0 0 0 0 
42 42 16 12 41 41 41 41 41 41 41 41 12 16 42 42 42 42 42 42 42 42 42 42 16 12 12 16 42 42 42 42 16 12 41 41 41 41 41 41 41 41 41 41 41 41 12 16 0 0 0 0 0 0 0 0 0 0 0 0 0 0 0 0 
42 42 16 12 41 41 41 41 41 41 41 41 12 16 42 42 42 42 42 42 42 42 42 42 16 41 41 16 42 42 42 42 16 12 41 41 41 41 41 41 41 41 41 41 41 41 12 16 0 0 0 0 0 0 0 0 0 0 0 0 0 0 0 0 
16 16 16 12 41 41 41 41 41 41 41 41 12 16 16 16 42 42 42 42 42 42 42 42 16 12 12 16 42 42 42 42 16 12 41 41 41 41 41 16 44 16 41 41 41 41 12 16 0 0 0 0 0 0 0 0 0 0 0 0 0 0 0 0 
16 12 12 12 41 41 41 41 41 41 41 41 12 12 12 16 42 42 42 42 42 42 42 42 16 41 41 16 42 42 42 42 16 12 12 41 41 41 41 16 41 16 41 41 41 12 12 16 0 0 0 0 0 0 0 0 0 0 0 0 0 0 0 0 
16 12 41 41 41 41 41 41 41 41 41 41 41 41 12 16 42 42 42 42 42 42 42 42 16 12 12 16 42 42 42 42 16 41 12 12 12 12 12 16 41 16 12 12 12 12 41 16 0 0 0 0 0 0 0 0 0 0 0 0 0 0 0 0 
16 16 16 16 16 16 16 12 12 16 16 16 16 16 16 16 42 42 42 42 42 42 42 42 16 41 41 16 42 42 42 42 16 16 16 16 16 16 16 16 16 16 16 16 16 16 16 16 0 0 0 0 0 0 0 0 0 0 0 0 0 0 0 0 
16 42 42 42 42 42 16 41 41 16 42 42 42 42 42 42 16 16 16 16 16 16 16 16 16 12 12 16 16 16 16 16 0 0 0 0 0 0 0 0 0 0 0 0 0 0 0 0 0 0 0 0 0 0 0 0 0 0 0 0 0 0 0 0 
16 42 42 42 42 42 16 12 12 16 42 42 42 42 42 42 16 41 41 41 41 41 41 41 41 41 41 41 41 41 41 16 0 0 0 0 0 0 0 0 0 0 0 0 0 0 0 0 0 0 0 0 0 0 0 0 0 0 0 0 0 0 0 0 
16 42 42 42 42 42 16 41 41 16 42 42 42 42 42 42 16 41 41 41 41 41 41 41 41 41 41 41 41 41 41 16 0 0 0 0 0 0 0 0 0 0 0 0 0 0 0 0 0 0 0 0 0 0 0 0 0 0 0 0 0 0 0 0 
16 42 42 42 42 42 16 12 12 16 42 42 42 42 42 42 16 41 41 39 39 39 39 39 39 39 39 39 39 41 41 16 0 0 0 0 0 0 0 0 0 0 0 0 0 0 0 0 0 0 0 0 0 0 0 0 0 0 0 0 0 0 0 0 
16 42 42 42 42 42 16 41 41 16 42 42 42 42 42 42 16 41 41 39 42 42 42 42 42 42 42 42 39 41 41 16 0 0 0 0 0 0 0 0 0 0 0 0 0 0 0 0 0 0 0 0 0 0 0 0 0 0 0 0 0 0 0 0 
16 42 42 42 42 42 16 12 12 16 42 42 42 42 42 42 16 41 41 39 39 39 39 39 39 39 39 39 39 41 41 16 0 0 0 0 0 0 0 0 0 0 0 0 0 0 0 0 0 0 0 0 0 0 0 0 0 0 0 0 0 0 0 0 
16 42 42 42 42 42 16 41 41 16 16 16 16 16 16 16 16 41 41 41 41 41 41 41 41 41 41 41 41 41 41 16 0 0 0 0 0 0 0 0 0 0 0 0 0 0 0 0 0 0 0 0 0 0 0 0 0 0 0 0 0 0 0 0 
16 42 42 42 42 42 16 12 12 41 12 41 12 41 12 41 45 41 41 41 41 41 41 41 41 41 41 41 41 41 41 16 0 0 0 0 0 0 0 0 0 0 0 0 0 0 0 0 0 0 0 0 0 0 0 0 0 0 0 0 0 0 0 0 
16 42 42 42 42 42 16 41 12 41 12 41 12 41 12 41 46 41 41 41 41 41 41 41 41 41 41 41 41 41 41 16 0 0 0 0 0 0 0 0 0 0 0 0 0 0 0 0 0 0 0 0 0 0 0 0 0 0 0 0 0 0 0 0 
16 42 42 42 42 42 16 16 16 16 16 16 16 16 16 16 16 41 41 41 41 41 41 41 41 41 41 41 41 41 41 16 0 0 0 0 0 0 0 0 0 0 0 0 0 0 0 0 0 0 0 0 0 0 0 0 0 0 0 0 0 0 0 0 
16 42 42 42 42 42 42 42 42 42 42 42 42 42 42 42 16 41 41 39 39 39 39 39 39 39 39 39 39 41 41 16 0 0 0 0 0 0 0 0 0 0 0 0 0 0 0 0 0 0 0 0 0 0 0 0 0 0 0 0 0 0 0 0 
16 42 42 42 42 42 42 42 42 42 42 42 42 42 42 42 16 41 41 39 42 42 42 42 42 42 42 42 39 41 41 16 0 0 0 0 0 0 0 0 0 0 0 0 0 0 0 0 0 0 0 0 0 0 0 0 0 0 0 0 0 0 0 0 
16 42 42 42 42 42 42 42 42 42 42 42 42 42 42 42 16 41 41 39 39 39 39 39 39 39 39 39 39 41 41 16 0 0 0 0 0 0 0 0 0 0 0 0 0 0 0 0 0 0 0 0 0 0 0 0 0 0 0 0 0 0 0 0 
16 42 42 42 42 42 42 42 42 42 42 42 42 42 42 42 16 41 41 41 41 41 41 41 41 41 41 41 41 41 41 16 0 0 0 0 0 0 0 0 0 0 0 0 0 0 0 0 0 0 0 0 0 0 0 0 0 0 0 0 0 0 0 0 
16 42 42 42 42 42 42 42 42 42 42 42 42 42 42 42 16 41 41 41 41 41 41 41 41 41 41 41 41 41 41 16 0 0 0 0 0 0 0 0 0 0 0 0 0 0 0 0 0 0 0 0 0 0 0 0 0 0 0 0 0 0 0 0 
16 16 16 16 16 16 16 16 16 16 16 16 16 16 16 16 16 16 16 16 16 16 16 16 16 16 16 16 16 16 16 16 0 0 0 0 0 0 0 0 0 0 0 0 0 0 0 0 0 0 0 0 0 0 0 0 0 0 0 0 0 0 0 0 
